1111111111111111111
1000000000C00000001
1C00000000000000001
1000000000000000001
1E000000000000C0001
1111111100000000001
1C00000000000000001
100000000000000C001
1P00000000000000001
1111111111111111111
